11101110
10111011
10001000
11101110
11101110
10111011
10001000
111011E0