PPPPPPPPPPPPPPPWPPPPPPPPPPPPPPPP
PPPPPPPPPPPPPPPWPPPPPPPPPPPPPPPP
PPPPPPPPPPPPPPPPPPPPPPPPPPPPPPPP
PPPPPPPPPPPPPPPWPPPPPPPPPPPPPPPP
PPPPPPPPPPPPPPPWPPPPPPPPPPPPPPPP
PPPPPPPPPPPPPPPWPPPPPPPPPPPPPPPP
PPPPPPPPPPPPPPPWPPPPPPPPPPPPPPPP
PPPPPPPPPPPPPPPWPPPPPPPPPPPPPPPP
PPPPPPPPPPPPPPPWPPPPPPPPPPPPPPPP
PPPPPPPPPPPPPPPWPPPPPPPPPPPPPPPP
PPPPPPPPPPPPPPPWPPPPPPPPPPPPPPPP
PPPPPPPPPPPPPPPWPPPPPPPPPPPPPPPP
PPPPPPPPPPPPPPPWPPPPPPPPPPPPPPPP
PPPPPPPPPPPPPPPWPPPPPPPPPPPPPPPP
PPPPPPPPPPPPPPPWWWWWWWWWWWWWWWWP
PPPPPPPPPPPPPPPWPPPPPPPPPPPPPPPP
PPPPPPPPPPPPPPPWPPPPPPPPPPPPPPPP
PPPPPPPPPPPPPPPWPPPPPPPPPPPPPPPP
PPPPPPPPPPPPPPPWPPPPPPPPPPPPPPPP
PPPPPPPPPPPPPPPWPPPPPPPPPPPPPPPP
PPPPPPPPPPPPPPPWPPPPPPPPPPPPPPPP
PPPPPPPPPPPPPPPWPPPPPPPPPPPPPPPP
PPPPPPPPPPPPPPPWPPPPPPPPPPPPPPPP
PPPPPPPPPPPPPPPWPPPPPPPPPPPPPPPP
PPPPPPPPPPPPPPPWPPPPPPPPPPPPPPPP
PPPPPPPPPPPPPPPWPPPPPPPPPPPPPPPP
PPPPPPPPPPPPPPPWPPPPPPPPPPPPPPPP
PWPWPPPPPPPPPPPWPPPPPPPPPPPPPPPP
PPWWPPPPPPPPPPPPPPPPPPPPPPPPPPPP
EPWPPPPPPPPPPPPWPPPPPPPPPPPPPPPP
