00000000000000000000000000000000
01110111010111111111110111111111
00010101010100010000010000010000
01110101011101110111111101110111
01000101000001000000000101000101
01110101110111011111011101111101
00010100010100010001010000000001
01011101110111111101010111011101
01000001000100000001010101010101
01011111011101111111011101010101
01010000010001000000000001010101
01010111110111011111111111010111
01010000000100010000000001010000
01011111110101111101011101110111
01000000010100000101010101000101
01011111110111011111010101011101
01010000000101000000010101010001
01011101011101111111010101010101
01000101010000000001010100010101
01011101011101011111010111011101
01010001000101010001010001010001
01110111111111010111010111010111
01000100000000010000010100010100
01010101110111011101110111010111
01010100010101000101000001010001
01011101110101110101011101110111
01000101010100010101000100000100
01110111010101110111111111110111
00010100000101000000000000000001
01010101110101111111011101110111
01010001010100000001010101010101
01111111011101111111110111011101